NO ./textures/vertical-shot-branches-green-tree-perfect-background.xpm
SO ./textures/vertical-shot-branches-green-tree-perfect-background.xpm
WE ./textures/vertical-shot-branches-green-tree-perfect-background.xpm
EA ./textures/vertical-shot-branches-green-tree-perfect-background.xpm

C 225,30,01
F 220,100,0


11111111111111111111111111111
10000000000000000000000000001
10000000000000000000000000001
10000000000000000000000000001
10000000000000000000000000001
100000000000N0000000000000001
10000000000000000000000000001
10000000000000000000000000001
10000000000000000000000000001
10000000000000000000000000001
11111111111111111111111111111
