NO textures/no.xpm

		 SO 	textures/so.xpm  
WE textures/we.xpm
EA textures/ea.xpm

C 9,2,84
F 91,91,91

1111111111111111111111111
1000000000110000000000001
1011000001110000000000001
100100000000000000001000E1
111111111011000001110001011111111
100000000011000001110111011111111
11110111111111011100000101001
11110111111111011101010101001
11000000110101011111111101001
1000000000000000111    101001
10000000000000001101111101001
110000011101010111110100000111
11110111 1110101 101111110001
11111111 1111111 111111111111
