NO textures/omi.xpm
SO textures/test.xpm
WE textures/omi.xpm
EA textures/test.xpm

C 225,30,01
F 220,100,0

11111111111111111111111
10000000000000000000001
10000000000000000000001
10000000000E00000000001
10000000000000000000001
10000000000000000000001
10000000000000000000001
10000000000000000000001
11111111111111111111111
