NO ./textures/vertical-shot-branches-green-tree-perfect-background.xpm 
SO ./textures/vertical-shot-branches-green-tree-perfect-background.xpm    
WE ./textures/vertical-shot-branches-green-tree-perfect-background.xpm   
EA ./textures/vertical-shot-branches-green-tree-perfect-background.xpm

C 225,30,01
F 220,100,0

11111111111111111111111111111
11110111111111011100000010001
11110111111111011101010010001
11000000110101011100000010001
10000000000000001100000010001
10000000000000001101010010001
11000001110101011111011110N01
11111111111111111111111111111